Hacía calor aquel día	La	m	
cuando Abraham	Re	m	Mi
estaba sentado delante de su tienda.	La	m	
Hacía calor aquel día			
cuando Abraham	Re	m	Mi
estaba sentado			
cerca del encinar de Mambré.	La	m	
Alzando los ojos, miró	Sol		Fa
y tres hombres de pie	Mi		
estaban delante.	La	m	
En cuanto los vio,	Mi		
se inclinó hasta el suelo y dijo:	La	m	
«Oh Señor mío,	Sol		
no pases, te ruego, sin detenerte.	Fa		Mi
«SIN DETENERTE,	La	m	
NO PASES, TE RUEGO,	Sol		
SIN DETENERTE, SIN DETENERTE».	Fa		Mi

«Os traeré un poco de agua,	La	m	Mi
os lavaré los pies			
y reposaréis a la sombra.	La	m	
Os traeré un bocado,	Mi		
os reconfortaréis			
y lúego seguiréis adelante.	La	m	
No por casualidad	Sol		
habéis pasado hoy delante de mí.	Fa		Mi
«OH SEÑOR MÍO,	La	m	
NO PASES, TE RUEGO,	Sol		
SIN DETENERTE, SIN DETENERTE.	Fa		Mi
SIN DETENERTE,	La	m	
NO PASES, TE RUEGO,	Sol		
SIN DETENERTE, SIN DETENERTE».	Fa		Mi
