ALELÚ, ALELÚ, ALE E LU U YA.	La	Si♭	La
ALELÚ, ALELÚ, ALE E LU U YA.	Si♭	La
Bendecid al Señor, bendecid al Señor,	Rem
vosotros los siervos del Señor.	La	7
Bendecid al Señor, bendecid al Señor,	
vosotros que estáis en la casa del Señor.	Rem
Alzad a Él las manos, alzad a Él las manos	Rem
y bendecid al Señor,	La	7
vosotros que estáis en la casa del Señor	
durante la noche.	Rem
ALELUYA, ALELUYA, A A LE E LU U YA.	Re	m	La	7	Si♭	La
ALELUYA, ALELUYA, A A LE E LU U YA.	Re	m	La	7	Sib	La
ALELÚ, ALELÚ, ALE E LU U YA ...	La	Si♭	La
BENDECID AL SEÑOR ...	Rem
BENDECID AL SEÑOR, BENDECID AL SEÑOR,	Rem
VOSOTROS LOS SIERVOS DEL SEÑOR.	La	7
BENDECID AL SEÑOR, BENDECID AL SEÑOR,	
VOSOTROS QUE ESTÁIS EN LA CASA DEL SEÑOR.	Rem
ALZAD A ÉL LAS MANOS, ALZAD A ÉL LAS MANOS	Rem
Y BENDECID AL SEÑOR,	La	7
VOSOTROS QUE ESTÁIS EN LA CASA DEL SEÑOR	
DURANTE LA NOCHE.	Rem
ALELUYA, ALELUYA ...	Re	m	La	7
Aalelú, alelú uuu ... uuya.	Si♭	La	7
ALELÚ, ALELÚ, ALE E LU U YA ...	La	Si♭	La
