ASÍ HABLA EL AMÉN,	Mi	m
EL TESTIGO FIEL Y VERAZ,	Do		Re	7
EL PRINCIPIO	
DE LAS CRIATURAS DE DIOS.	Mi	m

Conozco tu conducta:	Mi	m
no eres ni frío ni caliente.	Sol
¡Ojalá fueras frío o caliente	Re	7
y no tibio!	Si	7
Porque voy a vomitarte de mi boca.	Mi	m

Tú dices: «Yo soy rico, nada me falta»,	Mi	m
y no te das cuenta	Sol
que eres un desgraciado,	Re	7
digno de compasión,	Si	7
pobre, ciego y desnudo.	Mi	m

ASÍ HABLA EL AMÉN ...	Mi	m

Te aconsejo que me compres	Mi	m
oro acrisolado al fuego,	Sol
para que te enriquezcas,	Re	7
y vestidos blancos	Si	7

para cubrir tu desnudez.	Mi	m
Mira que estoy a la puerta y llamo;	Mi	m
si alguno oye mi voz y me abre,	Sol
entraré en su casa,	Re	7	Si	7
y cenaré con él y él conmigo.	Mi	m

ASÍ HABLA EL AMÉN ...	Mi	m