JUNTO A LOS CANALES DE BABILONIA,	Mi	m	La	m	Mi	m
ACORDÁNDONOS DE TI,	Si	7
NOS SENTAMOS A LLORAR.	Mi	m

DE LOS SAUCES COLGABAN	La	m
LAS GUITARRAS,	Mi	m
ACORDÁNDONOS DE TI,	Si	7
NOS SENTAMOS A LLORAR.	Mi	m

«CANTADNOS», NOS DECÍAN	La	m
NUESTROS ENEMIGOS.	Mi	m
«CANTADNOS», NOS DECÍAN	La	m
NUESTROS OPRESORES.	Mi	m
ELLOS QUERÍAN QUE NOSOTROS	Si	7
LES DIVIRTIÉRAMOS.	Mi	m

¿Cómo cantar un cántico del Señor	Re
en tierra extraña?	Mi	m
Si de Ti yo me olvidare,	Si	7
que se me seque la mano derecha	Mi	m

Que se me pegue la lengua al paladar,	Mi	m	La	m	Mi	m
si de ti yo me olvidare, Jerusalén,	Si	7
en la cumbre de mi alegría.	Mi	m

SEÑOR, TOMA CUENTAS	Mi	m	La	m
A NUESTROS ENEMIGOS.	Mi	m
SEÑOR, TOMA CUENTAS	La	m
A NUESTROS OPRESORES.	Mi	m
CUANDO ELLOS SE DECÍAN:	Si	7
¡ARRASADLA HASTA EL CIMIENTO!	Mi	m

Capital de Babilonia criminal,	Re	Mi	m
¡quién pudiera pagarte	Re
los males que nos has hecho!	Mi	m
¡Quién pudiera estrellar	Si	7
tus hijos contra la piedra!	Mi	m

JUNTO A LOS CANALES ...	Mi	m	La	m