BENDECIRÉ AL SEÑOR EN TODO TIEMPO,	Re	m
EN MI BOCA SIEMPRE SU ALABANZA;	Do	La
YO ME GLORÍO EN EL SEÑOR,	Si♭	La	7
LO ESCUCHEN LOS HUMILDES	Si♭
Y SE ALEGREN.	La	7

Cantad conmigo al Señor,	Re	m
cantemos juntos a su Nombre.	Do	La
Porque este pobre grita, el Señor le escucha,	Si♭	La
y le libra de todas sus angustias.	Si♭	La

BENDECIRÉ AL SEÑOR ...	Re	m

Porque el ángel del Señor acampa	Re	m
en torno a aquellos que le temen y les salva.	Do	La
Gritan ellos, y el Señor les escucha	Si♭
y los libra de todas sus angustias.	Si♭	La

DERECHA.....	Re	m

Gustad y ved	
qué bueno es el Señor,	Do	La
dichoso el hombre	Si♭
que se refugia en Él.	La

GUSTAD Y VED	Re	m
QUÉ BUENO ES EL SEÑOR,	Do	La
DICHOSO EL HOMBRE	Si♭
QUE SE REFUGIA EN ÉL.	La

Porque muchas son las pruebas	Re	m
que le esperan al Justo,	
mas de todas le libra el Señor.	Do	La
Gritan ellos, y el Señor les escucha	Si♭	La
y los libra de todas sus angustias.	Si♭	La

BENDECIRÉ AL SEÑOR ...	Re	m