BENDITO SEA DIOS	Re		Mi	m	La	7	Re
Y PADRE DE JESUCRISTO.	Mi	m	La	7	Re

Que nos ha bendecido	Fa#
con toda clase de amor;	Si	m
y nos ha elegido	Fa#
antes de la creación,	Si	m
para ser santos e inmaculados	La		Sol
en el amor.	Fa#

PARA SER ALABANZA DE SU GLORIA,	Si	m
DE LA GLORIA DE SU GRACIA,	La
DE LA GRACIA DE SU AMOR,	Sol
CON LA QUE NOS AMÓ EN JESUCRISTO.	Fa#

BENDITO SEA DIOS ...	Re	Mi	m	La	7	Re
--------------------------------	Fa#	Si	m
En Él tenemos la redención,	Fa#
el perdón de los pecados,	Si	m
según la riqueza de su amor,	Sol
para que en la plenitud de los tiempos	Fa#
Cristo sea todo en todos.	Si	m

PARA SER ALABANZA ...	Re	Mi	m	La	7	Re

BENDITO SEA DIOS ...	Fa#

En Él también nosotros,	Si	m
tras haber escuchado la Palabra de la verdad,	Fa#
la Buena Nueva	Si	m
de nuestra salvación,	La		Sol
fuimos sellados con el Espíritu Santo,	Fa#
garantía de nuestra resurrección.	Si	m

PARA SER ALABANZA ...	