Bendito sea el Señor,	Re	m
DIOS DE ISRAEL,	Sol	m	Re	m
porque ha visitado y redimido a su pueblo,
SUSCITÁNDONOS	Sol	m
UNA FUERZA DE SALVACIÓN	Re	m
EN LA CASA DE DAVID, SU SIERVO.	La	7	Re	m

Según lo había predicho desde antiguo	Sol	m	Re	m
por boca de sus santos profetas.	Sol	m	Re	m
Es la salvación que nos libra de nuestros enemigos	La	7
y de la mano de todos los que nos odian.	Re	m

Realizando así la misericordia	Sol	m
que tuvo con nuestros padres,	Re	m
recordando su santa alianza	Sol	m	Re	m
y el juramento que juró	La	7
a nuestro padre Abraham,	Re	m
para concedernos que, libres de todo temor,	Sol	m	Re	m
arrancados de la mano de nuestros enemigos,	Sol	m	Re	m
le sirvamos con santidad y justicia,	La	7
en su presencia, todos nuestros días.	Re	m	La	7	Re	m

BENDITO SEA EL SEÑOR...	Re	m

Y a ti, niño,	Sol	m
te llamarán profeta del Altísimo,	Re	m
porque irás delante del Señor	Sol	m
a preparar sus caminos,	Re	m
anunciando a su pueblo la salvación,	La	7
el perdón de todos sus pecados.	Re	m

Por la entrañable misericordia	Sol	m
de nuestro Dios,	Re	m
nos visitará el sol que nace de lo alto,	Sol	m	Re	m
para iluminar a los que viven en tinieblas	La	7
y en sombra de muerte,	Re	m
para guiar nuestros pasos	La	7
por el camino de la paz.	Re	m

BENDITO SEA EL SEÑOR...	Re	m