Están rotas mis ataduras,	La	m	Mi		Fa
pagadas mis deudas,	Re	m	Mi
mis puertas de par en par ...	Fa
¡me voy a todas partes!	Mi

Ellos, acurrucados en su rincón,	Re	m	Mi
siguen tejiendo	Re	m
el pálido lienzo de sus horas;	Mi
o vuelven a sentarse en el polvo,	Fa
a contar sus monedas.	Mi
Y me llaman, y me llaman	Fa		Mi
para que no siga.	Fa		Mi

¡Pero ya mi espada está forjada,	La m	Mi	m
ya tengo puesta mi armadura,	La m	Mi	m
ya mi caballo se impacienta!...	Sol		Si
¡Y yo ganaré mi reino!	Re		La		Fa#
¡Y yo ganaré mi reino!	Si	m	Sol		Fa#

------------------------------	

¡GANARÉ MI REINO,	Re		La
GANARÉ MI REINO,	Re		La
ME VOY A TODAS PARTES!	Mi		La

¡GANARÉ MI REINO,	Re		La
GANARÉ MI REINO,	Re		La
ME VOY A TODAS PARTES!	Mi		La

ESTÁN ROTAS MIS ATADURAS,	La	m	Mi		Fa
PAGADAS MIS DEUDAS,	Re	m	Mi
MIS PUERTAS DE PAR EN PAR ...	Fa
¡ME VOY A TODAS PARTES!	Mi

¡GANARÉ MI REINO ...	Re		La