Hasta el presente, pasamos hambre,	La	m		Sol
pasamos sed y desnudez.	La	m
Somos abofeteados,	Sol
y andamos errantes.	La	m

SOMOS ABOFETEADOS,	Sol
Y ANDAMOS ERRANTES.	La	m

Insultados, bendecimos,	Sol		La	m
perseguidos, lo soportamos.	Sol		La	m
Si somos difamados,	Sol
respondemos con amor.	La	m
SI SOMOS DIFAMADOS,	Sol
RESPONDEMOS CON AMOR.	La	m

HEMOS VENIDO A SER,	La	m		Sol
HEMOS VENIDO A SER,	La	m
HEMOS VENIDO A SER,	Sol
LA BASURA DEL MUNDO,	La	m
EL ESTROPAJO DE TODOS.	Sol		La	m

--------------

Porque pienso que a nosotros,	La	m		Sol
los apóstoles,	La	m
Dios nos ha asignado	Sol
el último lugar.	La	m

COMO CONDENADOS A MUERTE,	Sol
COMO CONDENADOS A MUERTE.	La	m
COMO CONDENADOS A MUERTE,	Sol
COMO CONDENADOS A MUERTE.	La	m

Puestos como espectáculo	La	m		Sol
para el mundo,	La	m
para los ángeles,	Sol
para los hombres,	Fa
para los hombres.	Mi

COMO CONDENADOS A MUERTE ...	Sol

HEMOS VENIDO A SER ...	La	m		Sol