Cuando el Señor	Re
hizo volver	Mi	m
a los cautivos	Re
de Sión,	Mi	m
nos parecía soñar;	Re
la boca	Mi	m
se nos llenaba de risas,	Re
la lengua	Mi	m
de cantares.	Re		Re	7

PORQUE AL IR,	Sol
SE VA LLORANDO,	La		Re
LLEVANDO LA SEMILLA;	Mi	m	Re		Re	7

MAS AL VOLVER,	Sol
SE VIENE CANTANDO,	La		Re
TRAYENDO LAS GAVILLAS.	Mi	m	Re

¡Grandes cosas ha hecho,	Re
maravillas,	Mi	m
ha hecho el Señor con nosotros!	Re
Por eso	Mi	m
estamos alegres.	Re		Re	7

PORQUE AL IR ...	Sol