Decidle a los de corazón cansado,	La	m	Re	m9
decídselo, decídselo a los pobres:	La	m
«¡Ánimo, no temáis!	Fa		Mi
que vuestro Dios viene a salvaros».	Fa		Mi
Ya se abren los ojos de los ciegos,	La	m	Re	m9
se abren los oídos de los sordos.	La	m
El cojo salta como un ciervo,	Fa		Mi
grita de júbilo la lengua del mudo.	Fa		Mi
PORQUE SE ABRIRÁ UN CAMINO,	Do		Mi	m	Do
UN CAMINO DE SALVACIÓN;	Mi	m	La	m
UNA SENDA, UNA VÍA	Do		Mi	m
PARA LOS POBRES.	La	m
Y por ella retornarán	Mi	m
los rescatados del Señor.	La	m
Y POR ELLA RETORNARÁN	Mi	m
LOS RESCATADOS DEL SEÑOR.	La	m
--------------------------------------------
Todos los pobres, ciegos y cojos,	Mi	m
los alejados del Señor.	La	m
TODOS LOS POBRES, CIEGOS Y COJOS,	Mi	m
LOS ALEJADOS DEL SEÑOR.	La	m
¡Los pecadores!	Mi	m
Y CANTARÁN FELICIDAD,	Fa		Mi
Y CANTARÁN FELICIDAD.	Fa		Mi
ALELUYA, ALELUYA.	Fa		Mi
ALELUYA, ALELUYA.	Fa		Mi
ALELUYA, ALELUYA.	Fa		Mi
ALELUYA, ALELUY	Fa		Mi
 
