DELANTE DE LOS ÁNGELES	Do		Mi
PARA TI YO CANTARÉ, SEÑOR.	Re	m9
DELANTE DE LOS ÁNGELES	Sol
PARA TI SALMODIARÉ.	Mi
DARÉ GRACIAS A TU NOMBRE,	Re	m9
PARA TI SALMODIARÉ.	Fa		Mi
Te doy gracias, Señor, de todo corazón,	Do		Mi		Re	m9
porque tus promesas han superado tu fama.	Sol		Mi
Cuando te invoqué, tú me escuchaste,	Re	m9
diste fuerza y vigor a mi alma.	Fa		Mi
DELANTE DE LOS ÁNGELES ...	Do		Mi
Te darán gracias, Señor,	Do		Mi
los reyes de la tierra,	Re	m9
al escuchar las palabras de tu boca;	Sol		Mi
y cantarán en el camino del Señor,	Re	m9
dirán: «¡Qué grande es tu amor!».	Fa		Mi
DELANTE DE LOS ÁNGELES ...	Do		Mi
------------------------------------------
Sublime es el Señor,	Do		Mi
que mira hacia el humilde,	Re	m9
conoce al soberbio, le mira desde lejos.	Sol		Mi
Mas cuando yo camino	
en medio de la angustia,	Re	m9
extiende su mano y su diestra me salva.	Fa		Mi
DELANTE DE LOS ÁNGELES ...	Do		Mi
El Señor terminará en mí lo comenzado,	Do		Mi		Re	m9
porque es eterno su amor.	Sol		Mi
No abandona la obra de sus manos.	Re	m9
¡Señor, no nos abandones!	Fa		Mi
DELANTE DE LOS ÁNGELES ...	Do		Mi