DICHOSO EL HOMBRE	La	m	Fa
QUE NO SIGUE EL CONSEJO DE LOS IMPÍOS,	La	m	Fa
NI EN LA SENDA DE LOS PECADORES SE DETIENE,	La	m
NI EN EL BANCO DE LOS BURLONES SE SIENTA.	Fa		La	m
Mas se complace en la palabra del Señor,	Sol		Mi
sus salmos susurra día y noche.	Sol		Fa		Mi
Será como árbol plantado	La	m	Fa
junto a corrientes de agua.	La	m
SERÁ COMO ÁRBOL PLANTADO	Fa
JUNTO A CORRIENTES DE AGUA,	La	m
que da fruto a su tiempo,	Fa		Mi
nunca se marchitarán sus hojas;	Fa		Mi
todo lo que emprende le sale bien,	Sol		Fa		Mi
todo lo que emprende le sale bien.	Sol		Fa		Mi
--------------------
¡No así los impíos, no así!	La	m
Que son como la paja	Fa
que se lleva el viento.	La	m
¡NO ASÍ LOS IMPÍOS, NO ASÍ!	La	m
QUE SON COMO LA PAJA	Fa
QUE SE LLEVA EL VIENTO.	La	m
No resistirán en el juicio los impíos,	Fa		Mi
ni los pecadores	Fa
en la comunidad de los santos.	Mi
Porque el Señor cuida	Sol
el camino de sus fieles,	Fa		Mi
mas el camino de los impíos	Fa
acaba mal, acaba mal, acaba mal.	Mi		Fa		Mi
DICHOSO EL HOMBRE	La	m