Veo el cielo abierto,	Mi
y un caballo blanco,	Fa
el que lo monta lleva un manto,	Sol		Fa
lleno de sangre, lleno de sangre.	Mi
Sus ojos, llamas de fuego,	Fa
y en su boca hay una espada	Sol		Fa
para herir, para herir.	Mi
¿Cuál es su nombre?	Do
¿Cuál es su nombre?
SU NOMBRE ES,	Mi
SU NOMBRE ES	Mi
PALABRA DE DIOS.	La	m
Veo una bestia y un profeta	Mi		Fa
que se reúnen para un combate,	Sol		Fa
para un combate,	Mi
contra el que monta en el caballo	Fa
y lleva el manto lleno de sangre,	Sol		Fa
lleno de sangre.	Mi
ÉL PISA SOLO EN EL LAGAR	La	m
DE LA FURIOSA CÓLERA DE DIOS.	Mi		La	m
Veo la bestia que es capturada,	Do		Mi
y con ella el profeta,	La	m
por el que monta en el caballo	Mi
y lleva el manto lleno de sangre.	La	m
ALELUYA, ALELUYA,	La	m	Mi
ALELUYA, ALELUYA,	La	m
ALELUYA, ALELUYA,	Mi
¡ALELUYA!	La	m
C. ¿Cuál es su nombre?	Do
¿Cuál es su nombre?
SU NOMBRE ES,	Mi
SU NOMBRE ES	Mi
PALABRA DE DIOS.	La	m