El Señor es mi pastor,	La	m	Fa
nada me falta.	Mi
En prados de fresca hierba	
me apacienta.	La	m
EL SEÑOR ES MI PASTOR,	La	m	Fa
NADA ME FALTA.	Mi
HACIA LAS AGUAS DE LA VIDA	
ME CONDUCE.	La	m
Repara mis fuerzas y me lleva	Sol		Fa
por el camino del amor.	Mi
Repara mis fuerzas y me lleva	Sol		Fa
para la gloria de su nombre.	Mi
EL SEÑOR ES MI PASTOR ...	La	m	Fa
Aunque camine por valle oscuro,	Sol		Fa
no temeré,	Mi
porque Tú, porque Tú, porque Tú [melisma]	
vas conmigo;	La	m
--------------------------
Tu vara y tu cayado me consuelan,	Sol		Fa
me consuelan.	Mi
EL SEÑOR ES MI PASTOR ...	La	m	Fa
Preparas una mesa ante mí	Sol		Fa
frente a mis enemigos.	Mi
Me unges la cabeza con perfume,	Sol		Fa
mi copa rebosa.	Mi
EL SEÑOR ES MI PASTOR ...	La	m	Fa
Sí, tu amor y tu alegría	Sol		Fa
me acompañarán.	Mi
Sí, yo viviré	Sol		Fa
en tu casa eternamente.	Mi
EL SEÑOR ES MI PASTOR ...	La	m	Fa
SÍ, TU AMOR Y TU ALEGRÍA ...	Sol		Fa
EL SEÑOR ES MI PASTOR ...	La	m	Fa
