EN MEDIO DE AQUEL GENTÍO,	La	m
EN MEDIO DE TODA AQUELLA GENTE	Sol
UNA MUJER, UNA MUJER LE TOCÓ.	Mi		Fa		Mi
«¿Quién es el que me ha tocado?	La	m
¿Quién es el que me ha tocado?»	Sol
dijo Cristo, dijo Cristo y se paró.	Mi		Fa		Mi
Una mujer temblorosa,	La	m
una mujer temblorosa	Sol
dijo a Cristo: «¡He sido yo!	Fa		Mi
«Que soy una mujer impura,	La	m
que soy una mujer impura	Sol
que sufro flujo de sangre.	Fa		Mi
QUE SOY UNA MUJER IMPURA,	La	m
QUE SOY UNA MUJER IMPURA	Sol
QUE SUFRO FLUJO DE SANGRE.	Fa		Mi
------------------------------
Mas al tocar tu vestido,	La	m
mas al tocar tu vestido	Sol
el flujo de sangre se curó».	Fa		Mi
«Hija, tu fe,	La	m		Sol
tu fe te ha salvado».	Fa		Mi
EN MEDIO DE AQUEL GENTÍO ...	La	m
Si quieres tú tocar a Cristo,	La	m
si quieres tú tocar a Cristo,	Sol
lo puedes tocar con la fe.	Fa		Mi
Que Él es el Hijo de Dios,	La	m
que Él es el Hijo de Dios	Sol
que ha venido para curarte,	Fa
para salvarte.	Mi
EN MEDIO DE AQUEL GENTÍO ...	La	m