El Espíritu Santo es el yugo suave,	La	m	Mi
es el yugo suave y ligero.	La	m
EL ESPÍRITU SANTO ES EL YUGO SUAVE,	La	m	Mi
ES EL YUGO SUAVE Y LIGERO.	La	m
Lleno de comprensión,	Re	m	Mi
lleno de misericordia con nuestras faltas,	Re	m	Mi
lleno de ternura y compasión	Fa
y de amor sin límites.	Mi
ES PACIENTE, ES BENIGNO,	La	m
ES EL SUMO BIEN,	Mi
ES EL DON DE DIOS,	La	m
ES LA GARANTÍA DE LA VIDA ETERNA,	Re	m	Mi
ES EL «PARÁCLITO•.	Re	m	Mi
Habitando en el hombre,	La	m
nos perdona siempre,	Mi
habitando en el hombre,	
espera siempre.	La	m
---------------------------------
Lo comprende todo, lo excusa todo.	Re	m	Mi
Nos defiende siempre,	Re	m
y nos enseña a ser pacientes	Fa
con nuestros pecados.	Mi
Nos dice quiénes somos,	Re	m	Mi
y nos dice dónde andamos,	Re	m	Mi
cuál es el camino y porqué sufrimos.	Fa		Mi
ES PACIENTE, ES BENIGNO ...	La	m
Nos dice que en nuestra vida todo es santo,	La	m	Mi
que nuestra historia es santa,	La	m
y nos conduce al abandono total en Cristo.	Re	m	Mi
En Él nada se pretende,	Re	m	Mi
se acepta todo, se soporta todo.	Fa		Mi
Porque parecerse al Señor sobre la Cruz	Re	m	Mi
es nuestra gloria, es la verdad,	Re	m
es la Santidad, es nuestro ser Cristiano.	Fa		Mi
ES PACIENTE, ES BENIGNO ...	La	m