ESCÓNDEME	La	m
EN LO OCULTO DE TU TIENDA,	Sol
SOBRE TU ROCA LEVÁNTAME.	Fa		Mi
Yahveh es mi luz y mi salvación,	La	m	Fa
¿a quién he de temer?	Mi
Yahveh es el refugio de mi vida,	La	m	Fa
¿por quién he de temblar?	Mi
ESCÓNDEME ...	La	m
Cuando se acercan contra mí los malvados	La	m	Fa
a devorar mi carne,	Mi
son ellos, mis adversarios y enemigos,	La	m	Fa
los que tropiezan y sucumben.	Mi
ESCÓNDEME ...	La	m
Aunque acampe un ejército contra mí,	La	m	Fa
mi corazón no teme;	Mi
aunque estalle una guerra contra mí,	La	m	Fa
estoy seguro en ella.	Mi
--------------------------------
ESCÓNDEME ...	La	m
Una cosa he pedido a Yahveh,	La	m	Fa
eso solo estoy buscando:	Mi
habitar en la Casa de Yahveh,	La	m	Fa
todos los días de mi vida.	Mi
ESCÓNDEME ...	La	m
Él me dará cobijo en su cabaña	La	m	Fa
el día de la desdicha;	Mi
me esconderá en lo oculto de su tienda,	La	m	Fa
sobre su roca me levantará.	Mi
ESCÓNDEME ...	La	m
Escucha, Yahveh, mi voz que clama,	La	m	Fa
¡tenme piedad, respóndeme!	Mi
Sí, Yahveh, tu rostro busco:	La	m	Fa
no me ocultes tu rostro.	Mi
ESCÓNDEME ...	La	m