Escuchad, islas lejanas,	La	7
prestad atención, naciones,	
así habla el Señor, el Santo de Israel:	
Aquel que tiene la vida despreciada	Re
y es el abominio de las gentes,	Fa#		Sol
al esclavo de los dominadores:	Fa#
TE VERÁN LOS REYES,	Re
SE PONDRÁN EN PIE.	
LOS PRÍNCIPES DE LA TIERRA	Fa#	m
SE INCLINARÁN,	Sol
YO TE HE ELEGIDO,	
TE HE ELEGIDO.	Fa#
En el día favorable te ayudaré,	Re
en el día de la muerte te asistiré,	Fa#	m	Sol
pues te he elegido	
como alianza a las naciones.	Fa#
TE VERÁN LOS REYES ...	Re
----------------------------------
Dirás a los prisioneros: «Salid»;	Re
dirás a los ciegos: «Mirad»;	Fa#	m	Sol
conducirás a los pueblos	
por el camino de la vida.	Fa#
TE VERÁN LOS REYES ...	Re
Mas Sión dice: «Yahveh me ha abandonado,	Si	m	Mi	m	Si	m
Yahveh me ha olvidado».	Mi	m	Si	m
¿Acaso una madre olvida a su hijo de pecho,	Sol		Fa#
es que se olvida del hijo de su seno?	Sol		Fa#
PUES AUNQUE UNA MADRE	Re		Fa#	m
SE OLVIDASE DE SU HIJO,	Sol
YO JAMÁS TE OLVIDARÉ.	Fa#
MÍRAME, EN LAS PALMAS DE MIS MANOS	Sol
TE LLEVO TATUADA.	Fa#
MÍRAME, EN LAS PALMAS DE MIS MANOS	Sol
TE LLEVO TATUADA.	Fa#
TE VERÁN LOS REYES ...	Re