ESTE ES EL MANDAMIENTO MÍO:	La	m	Do		Mi
QUE OS AMÉIS.	La	m
ESTE ES EL MANDAMIENTO MÍO:	Do		Mi
QUE OS AMÉIS	La	m
LOS UNOS A LOS OTROS	Do		Mi
COMO YO OS HE AMADO,	La	m
COMO YO OS HE AMADO,	Fa		Mi
COMO YO OS HE AMADO.	Fa		Mi
Nadie tiene mayor amor	La	7
que el que da su vida por sus amigos.	Re	m
Vosotros sois mis amigos,	Mi
vosotros sois mis amigos.	Fa		Mi
Vosotros sois mis amigos,	La	m	Sol
vosotros sois mis amigos.	Fa		Mi
No me habéis elegido vosotros a mí,	Re	m	Mi
NO ME HABÉIS ELEGIDO	Re	m
VOSOTROS A MÍ,	Mi
---------------------------------------------
sino que yo os he elegido a vosotros,	Re	m	Mi
SINO QUE YO	Re	m
OS HE ELEGIDO A VOSOTROS.	Mi
Si el mundo os odia	La	7
sabed que antes me ha odiado a mí;	Re	m
si el mundo os odia.	Mi
Padre, como tú estás en mí y yo estoy en ti,	La	7		Re	m	Mi
que ellos sean uno en nosotros,	Re	m	Mi
QUE ELLOS SEAN UNO EN NOSOTROS,	Re	m	Mi
para que el mundo crea	Fa
que tú me has enviado,	Mi
PARA QUE EL MUNDO CREA	Fa
QUE TÚ ME HAS ENVIADO.	Mi
ESTE ES EL MANDAMIENTO MÍO:	Re	m	Mi
QUE OS AMÉIS COMO YO OS HE AMADO,	Re	m	Mi
QUE OS AMÉIS COMO YO OS HE AMADO.	Fa		Mi