TE BENDECIMOS EN ESTA HORA,	Mi	m
¡OH CRISTO MÍO!, VERBO DE DIOS,	La	m
LUZ DE LA LUZ SIN COMIENZO.	Mi	m
TE BENDECIMOS, VERBO DE DIOS,	Si7		Mi	m
TE BENDECIMOS, VERBO DE DIOS.	Si7		Mi	m
Te bendecimos, ¡oh triple luz	Re7		Sol
de una indivisa gloria!	Si7	
Has dominado las tinieblas,	Mim	
has hecho resurgir la luz	Si7	
resucitando de la noche.	Mim	
Tú eres la eterna luz	Si7	
que ilumina nuestras vidas.	Mim	
Tú eres la eterna luz	Si7	
que alboreas sobre el mundo.	Mim	
Tú eres la eterna luz,	Si7	
te bendecimos, Señor.	Mim	
TE BENDECIMOS EN ESTA HORA,...	Mi	m
¡OH CRISTO MÍO!, VERBO DE DIOS,	La	m
LUZ DE LA LUZ SIN COMIENZO.	Mi	m
TE BENDECIMOS, VERBO DE DIOS,	Si7		Mi	m
TE BENDECIMOS, VERBO DE DIOS.	Si7		Mi	m