Aunque hablara las lenguas de los ángeles,	Do
si no tengo amor, nada.	La	m	Fa		Sol
Aunque tuviera el don de profecía	Do
y conociera todos los misterios,	La	m
aunque tuviera plenitud de fe	Do
y pudiera trasladar montañas,	La	m
si no tengo amor, nada.	Fa		Sol
Aunque repartiera	Do
todos mis bienes a los pobres	
y entregara mi cuerpo a las llamas,	Lam	
si no tengo amor, nada.	Fa		Sol
PORQUE EL AMOR,	Do
EL AMOR, EL AMOR,	La	m	Do
ES PACIENTE, ES SERVICIAL,	
NO ES ENVIDIOSO,	La	m
NO SE JACTA, NO SE ENGRÍE,	Do
ES DECOROSO,	La	m
NO BUSCA LO SUYO, NO SE IRRITA.	Fa		Sol
NO TOMA EN CUENTA EL MAL,	Do
NO TOMA EN CUENTA EL MAL,	La	m
NO SE ALEGRA DE LA INJUSTICIA,	Fa	
SE ALEGRA CON LA VERDAD.	Sol	
TODO LO CREE,	Do
TODO LO EXCUSA,	La	m
TODO LO ESPERA,	Do
SOPORTA TODO, SOPORTA TODO.	
PORQUE EL AMOR, EL AMOR,	Do	La	m
PORQUE EL AMOR ES DIOS	Do
ES DIOS, ES DIOS.	
