«ID Y ANUNCIAD A MIS HERMANOS	La	m
QUE VAYAN A GALILEA.	Sol		La	m
Que allí me verán,	Mi
QUE ALLÍ ME VERÁN».	La	m
Los discípulos fueron a Galilea,	La	m	Re	m	La	m
al monte que Jesús les había indicado.	Re	m	La	m
Cuando lo vieron le adoraron.	Mi		La	m
Y Jesús les dijo:	Fa		Mi
«Me ha sido dado todo poder	Do		Sol
en el cielo y en la tierra.	Do
ME HA SIDO DADO TODO PODER	Do		Sol
EN EL CIELO Y EN LA TIERRA.	Do
Id, pues, y haced discípulos	Do		Sol
a todas las gentes	Do
bautizándolas en el nombre del Padre	La	m	Mi
y del Hijo y del Espíritu Santo,	La	m
--------------------------------------
y enseñándoles a poner en práctica,	Fa
todo lo que yo os he mandado.	Mi		La	m
ID Y ANUNCIAD A MIS HERMANOS ...	La	m
Ved que yo estoy con vosotros,	La	m
ved que yo estoy con vosotros	Sol
todos los días.	La	m
VED QUE YO ESTOY CON VOSOTROS,	La	m
VED QUE YO ESTOY CON VOSOTROS	Sol
TODOS LOS DÍAS.	La	m
Hasta el fin del mundo,	Mi
HASTA EL FIN DEL MUNDO».	La	m
ID Y ANUNCIAD A MIS HERMANOS ...	La	m