Bendice, alma mía al Señor,	Mi	m	Re
bendice, alma mía, al gran Rey,	Mi	m
porque será reconstruida	Re
Jerusalén, Jerusalén.	Mi	m
JERUSALÉN, JERUSALÉN,	Mi	m	Re
JERUSALÉN, JERUSALÉN.	Mi	m
JERUSALÉN RECONSTRUIDA,	Re
JERUSALÉN PARA SIEMPRE.	Mi	m
Jerusalén será reconstruida,	Mi	m	Re
con zafiros y esmeraldas,	Mi	m
de piedras preciosas sus murallas,	Re
sus torres con oro puro.	Mi	m
Sus plazas serán de rubí,	Re
sus calles de oro de Ofir,	Mi	m
sobre sus puertas se exultará	Re
y en sus casas se cantará.	Mi	m
JERUSALÉN, JERUSALÉN ...	
Brillará tu luz hasta los confines de la tierra,	Mi	m	Re
vendrán a ti pueblos numerosos,	Mi	m
----------------------------------------
vendrán a ti todas las naciones,	Re
hasta la casa de tu Nombre.	Mi	m
Las generaciones te cantarán,	Re
todos los pueblos exultarán	Mi	m
y en ella el nombre de tu Elegido	Re
será para siempre, será para siempre.	Mi	m
JERUSALÉN, JERUSALÉN ...	
Malditos sean los que te dicen palabras crueles,	Mi	m	Re
malditos sean los que te destruyen,	Mi	m
todos los que derriban tus murallas,	Re
y tiran por tierra tus torres.	Mi	m
Mas sean benditos, benditos para siempre,	Re		Mi	m
los que te construyen, los que te edifican.	Re		Mi	m
Benditos los que te aman,	Re
los que lloran por tus castigos,	Mi	m
porque en tus puertas exultarán,	Re
porque en sus casas te cantarán.	Mi	m
JERUSALÉN, JERUSÉN ...	
ALELUYA, ALELUYA, ALELUYA, ALELUYA.	Mi	m	Re		Mi	m
ALELUYA, ALELUYA, ALELUYA, ALELUYA.	Re		Mi	m