Jesús recorría todas las ciudades.	La	m	Fa		La	m
Jesús de pueblo en pueblo	Fa
anunciaba el Reino.	La	m
Y viendo las gentes que lo seguían	Re	m	Mi	7
se conmovió.	La	m
ESTABAN CANSADOS,	Mi	m
ESTABAN ABATIDOS	Fa
COMO OVEJAS SIN PASTOR.	Mi
Entonces Jesús dijo a sus discípulos:	La	m	Fa		Mi	7
«La mies es grande,	La	m
es verdaderamente grande,	Sol
y los obreros son pocos.	La	m	Mi
Rogad, hermanos, al dueño de la mies	La	m	Sol
que envíe obreros a su mies.	La	m	Mi
Mirad que yo os envío	Do		Sol
como ovejas entre lobos.	La	m	Sol
Sed prudentes como serpientes	Do		Sol
y sencillos como palomas,	La	m	Sol
COMO PALOMAS.	La	m
--------------------------------------------
No llevéis ni bolsa ni dinero,	Do		Sol
ni alforja, ni calzado.	La	m	Sol
Y anunciad que el Reino está cerca,	Do		Sol
Cristo ha resucitado y viene con nosotros,	La	m	Sol
VIENE CON NOSOTROS.	La	m
El que ama a su padre o a su madre más que a mí,	Do
NO ES DIGNO DE MÍ, NO ES DIGNO DE MÍ.	Sol		La	m
El que ama a su hijo o a su hija más que a mí,	Do
NO ES DIGNO DE MÍ, NO ES DIGNO DE MÍ.	Sol		La	m
El que no tome su cruz y me siga,	Do
NO ES DIGNO DE MÍ, NO ES DIGNO DE MÍ.	Sol		La	m
Porque el que busca en este mundo su vida,	Do
LA PERDERÁ, LA PERDERÁ.	Sol		La	m
Y el que pierda su vida por el amor mío,	Do
LA ENCONTRARÁ, LA ENCONTRARÁ.	Sol		La	m
Quien os escucha, ME ESCUCHA A MÍ.	Sol		La	m
Quien os acoge, ME ACOGE A MÍ.	Sol		La	m
QUIEN ME ACOGE A MÍ,	Sol
ACOGE A DIOS, ACOGE A DIOS».	Fa		Mi