Era la Virgen María prometida de José,	Mi	m	La	m
cuando antes de que vivieran juntos,	Do
se encontró encinta por obra	
del Espíritu Santo.	Si	7
Y José, como era justo	Mi	m
y no quería repudiarla,	La	m
decidió abandonarla en secreto.	Do		Si	7
QUÉ AMARGA ES EL AGUA, MARÍA,	Mi	m
CORDERA DE DIOS, HUMILDE CORDERA,	Do
QUE NO TE RESISTES AL MAL.	Mi	m
MADRE DE JESÚS Y MADRE NUESTRA,	La	m
RUEGA POR NOSOTROS,	Si	7
RUEGA POR NOSOTROS.	Mi	m
María dio a luz a su hijo,	Mi	m
lo envolvió en pañales	La	m
y lo acostó en un pesebre	
porque no había sitio para ellos en la posada.	Do		Si	7
QUÉ AMARGA ES EL AGUA, MARÍA ...	Mi	m
--------------------------------
Y una noche José se levantó,	Mi	m
tomó al niño y a su madre	La	m
y huyó a Egipto	Do
porque querían matar al niño.	Si	7
QUÉ AMARGA ES EL AGUA, MARÍA ...	Mi	m
Un grito se siente en Ramá, ¡Ay Ayaay!	Mi	m
un llanto y un lamento grande:	La	m
es Raquel que llora a sus hijos,	Do
y no quiere ser consolada,	La	m
porque ya no existen.	Si	7
QUÉ AMARGA ES EL AGUA, MARÍA ...	Mi	m
El Ángel del Señor le dijo a José en Egipto:	Mi	m
«Levántate, toma contigo al niño y a su madre	La	m
y vuelve a la tierra de Israel,	Do		Si	7
porque "de Egipto llamé a mi Hijo"».	Mi	m
CORDERA DE DIOS ...	Do