¡La voz de mi amado!	Do		La	m
Helo aquí que viene,	Fa	
saltando por los montes,	Mi	
brincando por los collados.	Fa		Mi	
Semejante es mi amado a una gacela,	Do		La	m
o a un joven cervatillo,	Fa	
semejante es mi amado a una gacela.	Mi	
Vedle que ya se para	Do		La	m
detrás de nuestra cerca,	Fa	
mira por la ventana, atisba por la reja.	Mi	
Empieza a hablar mi amado y me dice:	Do	
¡LEVÁNTATE, AMADA MÍA,	Do		Mi	
LEVÁNTATE,	Fa	
HERMOSA MÍA, Y VENTE!	Mi	
Porque, mira, ha pasado ya el invierno,	Re	m	Mi	
han cesado las lluvias y se han ido,	Re	m	Mi	
aparecen las flores en la tierra,	Fa	
el tiempo de las canciones ha llegado.	Mi	
-------------------------------------------------------
Se oye el arrullo de la tórtola,	Re	m	Mi	
echa la higuera sus yemas	Fa	
y la viña exhala su fragancia.	Mi	
¡LEVÁNTATE, AMADA MÍA,...	
LEVÁNTATE,	Fa	
HERMOSA MÍA, Y VENTE!	Mi	
Paloma mía que vives en las grietas de la roca	Re	m	Mi	
en escarpados escondrijos,	Re	m	Mi	
déjame oír tu voz, déjame oír tu voz.	Fa		Mi	
Cazadnos las raposas,	Do	
las pequeñas raposas	Mi	
que devastan nuestra viña,	Fa		Mi	
porque nuestra viña está ya en flor,	Sol		Fa		Mi	
A. PORQUE NUESTRA VIÑA ESTÁ YA EN FLOR.	Sol		Fa		Mi	
Mi amado es para mí,	Re	m	Mi	
y yo soy para mi amado.	Re	m	Mi	
Antes que sople la brisa	Re	m	Mi	
y se alarguen las sombras con la muerte,	Re	m	Mi	
RETORNA, RETORNA, RETORNA.	La	m	Sol		La	m	1	A.
¡LEVÁNTATE, AMADA MÍA,...	
LEVÁNTATE,	Fa	
HERMOSA MÍA, Y VENTE!	Mi