PROCLAMA MI ALMA	Re	
LA GRANDEZA DEL SEÑOR,	Mi	
SE ALEGRA MI ESPÍRITU	
EN DIOS MI SALVADOR.	Re	
	La Mi La
Desde ahora me felicitarán	La	
todas las generaciones.	
DESDE AHORA ME FELICITARÁN	Mi	
TODAS LAS GENERACIONES.	La	
Porque el Poderoso	Re	
ha hecho grandes cosas en mí,	La	
su nombre es santo.	Mi		La	
PORQUE EL PODEROSO	Re	
HA HECHO GRANDES COSAS EN MÍ,	La	
SU NOMBRE ES SANTO.	Mi		La	
Él hace proezas con su brazo:	La	Mi	
dispersa a los soberbios de corazón.	La	
ÉL HACE PROEZAS CON SU BRAZO:	Mi	
DISPERSA A LOS SOBERBIOS DE CORAZÓN.	La	
----------------------------------------
Derriba a los poderosos	Re		La	
y ensalza a los humildes.	Mi		La
LOS HAMBRIENTOS	La	7	Re
COLMA DE BIENES	La	
Y A LOS RICOS DESPIDE VACÍOS.	Mi		La	
Auxilia a Israel, su siervo,	La	Mi	
acordándose de la misericordia.	La	
AUXILIA A ISRAEL, SU SIERVO,	Mi	
ACORDÁNDOSE DE LA MISERICORDIA.	La	
Como lo había prometido	Re		La	
en favor de Abraham.	Mi		La	
COMO LO HABÍA PROMETIDO	Re		La	
EN FAVOR DE ABRAHAM.	Mi		La	
PROCLAMA MI ALMA...	Re	
LA GRANDEZA DEL SEÑOR,	Mi	
SE ALEGRA MI ESPÍRITU	
EN DIOS MI SALVADOR.	Re