Mucho me han perseguido desde mi juventud,	La	m	Mi	
mucho me han perseguido, que lo diga Israel.	La	m
MUCHO ME HAN PERSEGUIDO	La	m
DESDE MI JUVENTUD,	Mi	
MUCHO ME HAN PERSEGUIDO,	
PERO NO HAN PODIDO CONMIGO.	La	m
Sobre mi espalda araron aradores,	La	m	Mi	
sobre mi espalda alargaron sus surcos.	La	m
A SOBRE MI ESPALDA ARARON	La	m
LOS ARADORES,	Mi	
SOBRE MI ESPALDA ALARGARON	
SUS SURCOS.	La	m
Mas el Señor, que es justo,	La	m	Mi	
rompió las coyundas de los malvados.	La	m
Mas el Señor, que es justo,	Mi	
rompió las coyundas de los malvados.	La	m
Retrocedan los que odian a Sión,	La	m	Mi	
retrocedan los que odian a Sión.	La	m
RETROCEDAN LOS QUE ODIAN A SIÓN,	La	m	Mi	
RETROCEDAN LOS QUE ODIAN A SIÓN.	La	m
Que sean como la hierba	La	m
que crece en el tejado,	Mi	
como la hierba que se seca	
antes de arrancarla.	La	m
De ella no llena el segador su mano,	Mi	
de ella no llena su regazo el gavillador.	La	m
RETROCEDAN LOS QUE ODIAN A SIÓN,...	La	m	Mi	
RETROCEDAN LOS QUE ODIAN A SIÓN.	La	m
MUCHO ME HAN PERSEGUIDO...	La	m
DESDE MI JUVENTUD,	Mi	
MUCHO ME HAN PERSEGUIDO,	
PERO NO HAN PODIDO CONMIGO.	La	m