SEÑOR, NO ME CORRIJAS EN TU CÓLERA,	Fa#	5/9	dlm*	Sol		Fa#	
EN TU FUROR NO ME CASTIGUES.	Sol		Fa#	
Ten piedad de mí, ten piedad Señor,	Sim		La	
que estoy sin fuerzas,	Fa#	
sáname tú, Señor,	Si	m	La	
que se desmoronan mis huesos.	Fa#	
Hundida tengo el alma,	Sol		Fa#	
y tú, Señor, ¿hasta cuándo?	La		Fa#	
Y TÚ, SEÑOR, ¿HASTA CUÁNDO?	La		Fa#	
SEÑOR, NO ME CORRIJAS EN TU CÓLERA...	Fa#	5/9	dlm*	Sol		Fa#	
EN TU FUROR NO ME CASTIGUES.	Sol		Fa#	
Vuélvete, Señor, recobra mi alma,	Si	m	La		Fa#	
sáname tú, Señor, por tu misericordia.	Si	m	La		Fa#	
Que nadie entre los muertos te recuerda,	La		Fa#	
ni en los infiernos se canta tu alabanza.	La		Fa#	
QUE NADIE ENTRE LOS MUERTOS	La	
TE RECUERDA, NI EN LOS INFIERNOS	Fa#		La	
SE CANTA TU ALABANZA.	Fa#	
SEÑOR, NO ME CORRIJAS EN TU CÓLERA...	Fa#	5/9	dlm*	Sol		Fa#	
EN TU FUROR NO ME CASTIGUES.	Sol		Fa#	
Estoy cansado de gemir,	Sim	
inundo de lágrimas mi cama,	La		Sim	
mis ojos se consumen en la angustia,	La	
envejezco entre enemigos.	Fa#	
Apartaos de mí, malvados,	La		Fa#	
que el Señor escucha mis sollozos,	La		Fa#	
que el Señor acoge mi oración.	La		Fa#	
SEÑOR, NO ME CORRIJAS EN TU CÓLERA...	Fa#	5/9	dlm*	Sol		Fa#	
EN TU FUROR NO ME CASTIGUES.	Sol		Fa#	
Y tú, Señor, ¿hasta cuándo?	La		Fa#	
Y TÚ, SEÑOR, ¿HASTA CUÁNDO?	La		Fa#