Alzando los ojos hacia	Re	
sus discípulos, Jesús decía:	La	7	Re	
DICHOSOS LOS POBRES,	Sol		Re	
PORQUE VUESTRO	La	7	
ES EL REINO DE DIOS.	Re	
DICHOSOS LOS QUE AHORA	
TENÉIS HAMBRE,	Sol		Re	
PORQUE SERÉIS SACIADOS.	La	7	Re	
DICHOSOS LOS QUE LLORÁIS AHORA,	Sol		Re	
PORQUE REIRÉIS.	La	7	Re	
Dichosos seréis cuando os odien,	Si	m	La	
os injurien a causa del Hijo del hombre.	Sol		Fa#	
Alegraos ese día, que vuestra recompensa	Sol	
será grande en el cielo.	Fa#	
¡AY DE VOSOTROS, LOS RICOS!	Re		Sol		Re	
PORQUE HABÉIS RECIBIDO	La7	
VUESTRO CONSUELO.	Re	
¡AY DE LOS QUE REÍS AHORA!	Sol		Re	
PORQUE TENDRÉIS AFLICIÓN	La	7	
Y LLANTO.	Re	
AMAD A VUESTROS ENEMIGOS,	Mi		La		Mi	
HACED EL BIEN A LOS QUE OS ODIAN.	Si7		Mi	
AL QUE TE HIERE EN UNA MEJILLA,	La		Mi	
PRESÉNTALE TAMBIÉN LA OTRA;	Si	7	Mi	
AL QUE TE QUITE EL MANTO,	Fa#		Si		Fa#	
NO LE NIEGUES LA TÚNICA;	Do#7		Fa#	
AL QUE TE QUITE LO QUE ES TUYO,	Si		Fa#	
NO SE LO RECLAMES.	Do#7		Fa#	
AMAD A VUESTROS ENEMIGOS,	Mi		La		Mi	
HACED EL BIEN A LOS QUE OS ODIAN.	Si	7	Mi	
NO JUZGUÉIS,	Fa#		Si		Fa#	
NO CONDENÉIS;	Si		Fa#	
PERDONAD	Si		Fa#	
Y SERÉIS PERDONADOS	Do#	7	Fa#