Tú has cubierto de vergüenza la muerte,	Re	m	La	7
tú has llenado de luto el infierno.	Re	m
Has golpeado la iniquidad,	La	7
has privado a la injusticia de sus hijos,	Re	m
como Moisés al Faraón,	Si♭	7	La	7
como Moisés al Faraón.	Si♭	7	La	7
Tú nos has pasado	Re	m
de la esclavitud a la libertad,	La	7
de las tinieblas a la luz,	Re	m
de la muerte a la vida,	La	7
de la tiranía al reino eterno.	Re	m
Tú eres la Pascua de nuestra salvación;	La	7
tú eres el cordero nacido de María.	Re	m
MARÍA, CORDERA SIN MANCHA,	Re	m	La	7
MARÍA, LA INOCENTE CORDERA.	Re	m
Tú has sido asesinado en Abel,	Re	m	La	7
tú fuiste atado en Isaac,	Re	m
vendido en José,	La	7
abandonado sobre las aguas en Moisés,	Rem	
perseguido en David	La	7
y despreciado en todos los profetas.	Re	m
Tú eres el cordero que no abre boca;	La	7
tú eres el cordero nacido de María.	Re	m
MARÍA, CORDERA SIN MANCHA...	Re	m	La	7
MARÍA, LA INOCENTE CORDERA.	Re	m
Tú fuiste cogido del rebaño,	Re	m	La	7
conducido al sacrificio, inmolado por la tarde,	Re	m
sepultado en la noche; sobre la cruz	La	7
no te fue roto ningún hueso, ni en la tierra	
experimentaste la corrupción.	Re	m
Tú resucitando de la muerte	La	7
has hecho resurgir a la humanidad	
de lo profundo del sepulcro.	Re	m
Tú eres el cordero que no abre boca;	La	7
tú eres el cordero nacido de María.	Re	m
MARÍA, CORDERA SIN MANCHA...	Re	m	La	7
MARÍA, LA INOCENTE CORDERA.	Re	m
