UNA GRAN SEÑAL APARECIÓ EN EL CIELO:	La	m
UNA MUJER, UNA MUJER VESTIDA DEL SOL,	Sol		La	m
CON LA LUNA BAJO SUS PIES,	
Y UNA CORONA DE DOCE ESTRELLAS;	Sol	
ESTÁ ENCINTA, Y GRITA	La	m
CON LOS TORMENTOS DE DAR A LUZ.	Fa		Mi	
Y apareció otra señal en el cielo:	La	m
un enorme Dragón rojo,	Sol	
con siete cabezas y diez cuernos.	Fa		Mi	
El Dragón se detuvo delante de la Mujer,	La	m
de la Mujer que iba a dar a luz,	Sol	
para devorar a su Hijo en cuanto naciera.	Fa		Mi	
Y la Mujer dio a luz un Hijo varón,	La	m
aquel que ha de regir las naciones de la tierra,	Sol	
y su Hijo fue arrebatado	Fa	
hasta Dios y hasta su trono.	Mi	
UNA GRAN SEÑAL APARECIÓ EN EL CIELO...	La	m
UNA MUJER, UNA MUJER VESTIDA DEL SOL,	Sol		La	m
CON LA LUNA BAJO SUS PIES,	
Y UNA CORONA DE DOCE ESTRELLAS;	Sol	
ESTÁ ENCINTA, Y GRITA	La	m
CON LOS TORMENTOS DE DAR A LUZ.	Fa		Mi	
Entonces se entabló una batalla en el cielo:	La	m
Miguel y sus Ángeles combatieron	Sol		Fa	
con el Dragón, con el gran Dragón.	Mi	
También el Dragón y sus ángeles combatieron,	La	m	Sol	
pero no prevalecieron	Fa	
y no hubo ya lugar para ellos en el cielo.	Mi	
Y fue arrojado el Dragón, el gran Dragón,	La	m
la Serpiente antigua, el llamado Diablo	
y Satanás, el seductor del mundo entero,	Sol		Fa	
fue arrojado a la tierra y sus ángeles con él.	Mi	
UNA GRAN SEÑAL APARECIÓ EN EL CIELO...	La	m
UNA MUJER, UNA MUJER VESTIDA DEL SOL,	Sol		La	m
CON LA LUNA BAJO SUS PIES,	
Y UNA CORONA DE DOCE ESTRELLAS;	Sol	
ESTÁ ENCINTA, Y GRITA	La	m
CON LOS TORMENTOS DE DAR A LUZ.	Fa		Mi	
C Cuando el Dragón vio que había sido	La	m
arrojado a la tierra, persiguió a la Mujer	Sol		Fa	
que había dado a luz al Hijo varón.	Mi	
Pero se le dieron a la Mujer las dos alas	La	m
del águila grande, para volar al desierto,	Sol		Fa	
donde tiene que ser alimentada	
un tiempo, dos tiempos y medio tiempo.	Mi	
Entonces, despechado contra la Mujer,	La	m
el gran Dragón, se fue a hacer la guerra	Sol	
al resto de sus hijos	Fa	
los que guardan los mandamientos de Dios	
y mantienen el testimonio de Jesús.	Mi	
LA LA LA, LA LA, LA LA...	