VEN, ESPÍRITU CREADOR,	La	m	Sol	
VISITA NUESTRA MENTE;	La	m
LLENA DE TU AMOR	Sol	
EL CORAZÓN QUE HAS CREADO.	La	m
Oh dulce consolador,	La	m	Sol	
don del Padre altísimo,	La	m
agua viva, fuego, amor,	Sol	
santo crisma del alma.	La	m
DEDO DE LA MANO DE DIOS,	La	m	Sol	
PROMESA DEL SALVADOR,	La	m
DERRAMA TUS SIETE DONES,	Sol	
SUSCITA EN NOSOTROS LA PALABRA.	La	m
Sé luz del intelecto,	La	m	Sol	
llama ardiente en el corazón,	La	m
sana nuestras heridas	Sol	
con el bálsamo de tu amor.	La	m
DEFIÉNDENOS DEL ENEMIGO,	La	m	Sol	
DANOS EL DON DE LA PAZ.	La	m
TU GUÍA INVENCIBLE	Sol	
NOS PRESERVE DEL MAL.	La	m
Oh Luz de eterna sabiduría,	La	m	Sol	
desvélanos el gran misterio	La	m
de Dios Padre y del Hijo,	Sol	
unidos en un solo amor.	La	m
AMÉN.	Sol		La	m