Yo te amo, Señor, tú eres mi roca,	Re		Fa#		Si	m
tú eres mi liberador, tú eres mi Dios.	Sol		Fa#	
Yo te amo, yo te amo, Señor.	Sol		Fa#	
LAS OLAS DE LA MUERTE ME ENVOLVÍAN,	Re		Si	m
ME ESPANTABAN LAS TROMBAS DE BELIAL,	Sol		Re	
ME RODEABAN LOS LAZOS DEL SEOL,	La		Sol	
HABÍA CAÍDO EN LOS CEPOS DE LA MUERTE.	Re	
Clamé al Señor en mi angustia,	Fa#	
a mi Dios, a mi Dios invoqué,	Sim	
y escuchó mi voz desde su templo,	La		Sol	
llegó mi llamada a sus oídos.	Fa#	
Y la tierra fue sacudida y vaciló,	Sol		Fa#	
retemblaron las bases de los montes.	Sol		Fa#	
Porque inclinó los cielos y bajó.	Sol		Fa#	
Y el fondo del mar quedó a la vista,	La		Fa#	
los cimientos del orbe aparecieron.	La		Fa#	
Extendió su mano para asirme,	Sol	
me sacó de lo profundo de las aguas.	Fa#	
YO TE AMO, SEÑOR, TÚ ERES MI ROCA...	Re		Fa#		Si	m
TÚ ERES MI LIBERADOR, TÚ ERES MI DIOS.	Sol		Fa#	
YO TE AMO, YO TE AMO, SEÑOR.	Sol		Fa#	
LAS OLAS DE LA MUERTE ME ENVOLVÍAN...	Re		Si	m
ME ESPANTABAN LAS TROMBAS DE BELIAL,	Sol		Re	
ME RODEABAN LOS LAZOS DEL SEOL,	La		Sol	