Así, pues, Padre, al celebrar ahora el memorial	Sol	
de la muerte y resurrección de tu Hijo,	Mi	m
te ofrecemos el pan de vida	La	m
y el cáliz de salvación,	Mi	m
y te damos gracias	La	m
porque nos haces dignos de servirte en tu presencia.	Mi	m
Te pedimos humildemente	Sol	
que el Espíritu Santo congregue en la unidad	Sim	
a cuantos participamos	La	m
del Cuerpo y Sangre de Cristo.	Mi	m
P Acuérdate, Señor, de tu Iglesia	Sol	
extendida por toda la tierra;	Mi	m
y con el Papa ... N/,	La	m
con nuestro obispo ... N/.	Mi	m
y de todos los que en ella cuidan de tu pueblo,	La	m
llévala a su perfección por la caridad.	Sol		Si	m	Mi	m
Acuérdate también de nuestros hermanos	Sol	
que durmieron en la esperanza de la resurrección,	Sim	
y de todos los que han muerto	La	m
en tu misericordia;	Mi	m
admítelos a contemplar la luz de tu rostro.	Sol		Si	m	Mi	m
Ten misericordia de todos nosotros,	Sol		Mi	m
y así, con María, la Virgen Madre de Dios,	La	m
su esposo San José,	Mi	m
los apóstoles	La	m
y cuantos vivieron en tu amistad	Mi	m
a través de los tiempos	
merezcamos, por tu Hijo Jesucristo,	Sol	
compartir la vida eterna	Sim	
y cantar tus alabanzas.	La		Mi	m
P. Por Cristo, con Cristo y en Cristo,	Sol	
a ti, Dios Padre omnipotente,	Sim	
en la unidad del Espíritu Santo,	La	m
todo honor y toda gloria	Mi	m
por los siglos de los siglos.	Sol	
AMÉN, AMÉN, AMÉN.	Sol		Si	m	La		Mi	m