Santo eres en verdad, Señor,	Sol	
fuente de toda santidad:	Mi	m	
santifica estos dones	La	m
con la efusión de tu Espíritu,	Mi	m	
de manera que sean para nosotros	Sol	
Cuerpo y ✠ Sangre	Si	m	
de Jesucristo, Nuestro Señor.	Mi	m	
El cual, cuando iba a ser entregado a su Pasión,	Sol	
voluntariamente aceptada,	Mi	m	
tomó pan,	La	m
dándote gracias,	Mi	m
lo partió	La	m
y lo dio a sus discípulos, diciendo:	Mi	m
Tomad y comed todos de él,	Sol
porque esto es mi Cuerpo,	Si	m
que será entregado por vosotros.	Mi	m
Del mismo modo, acabada la cena,	Sol
tomó el cáliz,	Mi	m
y dándote gracias de nuevo,	La	m
lo pasó a sus discípulos, diciendo:	Mi	m
Tomad y bebed todos de él,	Sol
éste es el cáliz de mi Sangre,	Si	m
Sangre de la alianza nueva y eterna,	La	m	Mi	m
que será derramada por vosotros	Sol
y por muchos,
para el perdón	Si	m
para el perdón	La
de los pecados.	Mi	m
Haced esto en conmemoración mía.	Sol		Si	m	Mi	m
Este es el sacramento de nuestra fe.	Sol
ANUNCIAMOS TU MUERTE, SEÑOR,	Sol
PROCLAMAMOS TU RESURRECCIÓN,	Si	m
¡VEN, SEÑOR JESÚS!	La		Mi	m
¡VEN, SEÑOR JESÚS!	La		Mi	m