El Señor esté con vosotros.	Sol		La	m
Y CON TU ESPÍRITU.	Sol		La	m
Levantemos el corazón.	Fa		Mi	
LO TENEMOS LEVANTADO HACIA EL SEÑOR.	Fa		Mi	
Demos gracias al Señor, nuestro Dios.	La	m
ES JUSTO Y NECESARIO.	Sol		La	m
Realmente es justo darte gracias,	La	m	Do	
y deber nuestro glorificarte, Padre santo,	Re		La	m
porque tú eres el único Dios vivo y verdadero	Do		Lam	
que existes desde siempre y vives para siempre;	Sol	
luz sobre toda luz.	La	m
Porque tú solo eres bueno y fuente de vida,	Do	
hiciste todas las cosas	Re	
para colmarlas de tus bendiciones	La	m
y alegrar su multitud con la claridad de tu gloria.	Sol		La	m
Por eso, innumerables ángeles en tu presencia,	Do		La	m
contemplando la gloria de tu rostro,	Re	
te sirven siempre y te glorifican sin cesar.	La	m
Y con ellos también nosotros, llenos de alegría,	Sol		La	m
y por nuestra voz las demás criaturas,	Do	
aclamamos tu nombre cantando:	Re		Mi	
SANTO, SANTO, SANTO ...	
Te alabamos, Padre santo, porque eres grande	La	m	Do	
y porque hiciste todas las cosas	Re	
con sabiduría y amor.	La	m
A imagen tuya creaste al hombre	Do	
y le encomendaste el universo entero,	Re	
para que, sirviéndote solo a ti, su Creador,	Fa	
dominara todo lo creado.	Sol		La	m
Y cuando por desobediencia perdió tu amistad,	Sol		La	m
no lo abandonaste al poder de la muerte,	Do	
sino que, compadecido,	Re	
tendiste la mano a todos,	Mi	
para que te encuentre	Re	
el que te busca	Mi	