Reiteraste tu alianza a los hombres;	La	m
por los profetas los fuiste llevando	Rem	
con la esperanza de la salvación.	Mi	
Padre Santo, tanto amaste al mundo	Do	
que, al cumplirse la plenitud de los tiempos,	La	m
nos enviaste como salvador	Do	
a tu único Hijo.	La	m
El cual se encarnó	Do	
por obra del Espíritu Santo,	Re	
nació de María, la Virgen,	La	m
y así compartió en todo	Sol	
nuestra condición humana	
menos en el pecado;	La	m
anunció la salvación a los pobres,	Do		La	m
la liberación a los oprimidos	Do	
y a los afligidos el consuelo.	La	m
Para cumplir tus designios,	Sol	
él mismo se entregó a la muerte	La	m
y, resucitando, destruyó la muerte.	Sol		La	m
RESUCITANDO,	Do	
DESTRUYÓ LA MUERTE	
Y NOS DIO NUEVA VIDA.	La	m
Y porque no vivamos ya para nosotros mismos,	La	m	Do	
sino para él,	Re	
que por nosotros murió y resucitó,	
envió, Padre, desde tu seno	La	m
al Espíritu Santo	Sol		La	m
como primicia para los creyentes,	Sol	
a fin de santificar todas las cosas,	
llevando a plenitud su obra en el mundo.	La	m
Y este mismo Espíritu	Do	
santifique, Señor,	Re	
estas ofrendas,	La	m
para que sean Cuerpo y   Sangre	Re	
de Jesucristo, nuestro Señor,	La	m
y así celebremos el gran misterio	Re	
que nos dejó, como alianza eterna.	La	m