Porque él mismo, llegada la hora	Do	
en que había de ser glorificado por ti, Padre santo,	La	m
habiendo amado a los suyos	Do	
que estaban en el mundo,	
los amó hasta el extremo.	La	m
Y, mientras cenaba con sus discípulos,	Fa	
tomó pan, te bendijo,	La	m
lo partió y se lo dio, diciendo:	Fa		Sol	
Tomad y comed todos de él,	La	m	Sol		La	m
porque esto es mi Cuerpo,	Sol	
que será entregado por vosotros.	La	m
Del mismo modo,	Do	
tomó el cáliz lleno del fruto de la vid	
y te dio gracias,	La	m
lo pasó a sus discípulos, diciendo:	Rem		Mi	
Tomad y bebed todos de él,	Sol		La	m
porque este es el cáliz de mi Sangre,	Sol	
Sangre de la alianza nueva y eterna,	La	m
que será derramada por muchos,	Sol	
para el perdón de los pecados.	La	m
Haced esto en conmemoración mía.	Fa		Mi	
Este es el sacramento de nuestra fe.	Sol		La	m
ANUNCIAMOS TU MUERTE, SEÑOR,	Do	
PROCLAMAMOS TU RESURRECCIÓN,	La	m
¡VEN, SEÑOR JESÚS!	Fa		Mi	
Por eso, nosotros, Señor, al celebrar ahora	La	m
el memorial de nuestra redención,	Sol		La	m
recordamos la muerte de Cristo	Fa	
y su descenso al lugar de los muertos,	La	m
proclamamos su resurrección	Fa	
y ascensión a tu derecha;	Mi	
y, mientras esperamos su venida gloriosa,	Fa		La	m
te ofrecemos su Cuerpo y su Sangre,	Sol	
sacrificio agradabíe a Ti	La	m
y salvación para todo el mundo.	Sol		La	m