El Señor esté con vosotros.	Sol		La	m
Y CON TU ESPÍRITU.	Sol		La	m
Levantemos el corazón.	Fa		Mi	
LO TENEMOS LEVANTADO HACIA EL SEÑOR.	Fa		Mi	
Demos gracias al Señor, nuestro Dios.	La	m
ES JUSTO Y NECESARIO.	Sol		La	m
En verdad es justo darte gracias,	Mlm	
Señor, Padre santo,	
Dios todopoderoso y eterno.	Sol	
Te alabamos, te bendecimos y te glorificamos	La	
por el misterio de la Virgen Madre.	Mim	
Porque, si del antiguo adversario nos vino la ruina,	Sol	
en el seno virginal de la hija de Sión ha germinado	La	
aquel que nos nutre con el pan de los ángeles,	
y ha brotado para todo el género humano	Mim	
la salvación y la paz.	
La gracia que Eva nos arrebató	Sol	
nos ha sido devuelta en María.	Mim	
En ella, madre de todos los hombres,	La	m
la maternidad,	
redimida del pecado y de la muerte,	Mim	
se abre al don de una vida nueva.	
Así, donde había crecido el pecado,	Sol	
se ha desbordado tu misericordia	La	
en Cristo, nuestro Salvador.	Mim	
Por eso nosotros,	Sol	
mientras esperamos la venida de Cristo,	Mim	
unidos a los ángeles y a los santos,	La	m
cantamos el himno de tu gloria:	Mim	
SANTO, SANTO, SANTO...	