Exulten los coros de los ángeles,	La	m	Sol		La	m
exulte la asamblea celeste,	Do		La	m
y un himno de gloria	Sol	
aclame el triunfo del Señor resucitado.	La	m
Alégrese la tierra, inundada por la nueva luz.	Fa		Mi	7	Fa		Mi	7
EL ESPLENDOR DEL REY	La	m
DESTRUYÓ LAS TINIEBLAS,	Sol	
DESTRUYÓ LAS TINIEBLAS,	Fa	
LAS TINIEBLAS DEL MUNDO.	Mi7	
Que se alegre nuestra madre la Iglesia,	La	m	Sol	
resplandeciente de la gloria de su Señor;	La	m	Do		La	m
y que en este lugar resuene unánime	Sol	
la aclamación de un pueblo en fiesta.	La	m
El Señor esté con vosotros.	Sol		La	m
A Y CON TU ESPÍRITU.	Sol		La	m
Levantemos el corazón.	Fa		Mi	
LO TENEMOS LEVANTADO HACIA EL SEÑOR.	Fa		Mi	
Demos gracias al Señor, nuestro Dios.	La	m
ES JUSTO Y NECESARIO.	Sol		La	m
Realmente es justo y necesario	La	m	Sol	
exaltar con el canto la alegría del espíritu	La	m	Do		La	m
y elevar un himno al Padre Todopoderoso,	Sol	
y a su único Hijo, Jesucristo.	La	m
Él ha pagado por todos al eterno Padre	Sol	
la deuda de Adán,	La	m
y con su Sangre, derramada por amor,	Do		La	m
ha cancelado la condena antigua del pecado.	Sol		La	m
Esta es la Pascua,	Fa		Mi7	
en que se inmola el Cordero.	Fa		Mi	
Esta es la noche	Fa		Mi7	
en que fueron liberados	Fa	
nuestros padres de Egipto.	Mi7	
Esta es la noche	Fa		Mi7	
que nos salva de la oscuridad del mal.	Fa		Mi	
ESTA ES LA NOCHE	La	m
EN QUE CRISTO HA VENCIDO LA MUERTE	Sol
Y DEL INFIERNO RETORNA VICTORIOSO.	Fa		Mi