¡Oh admirable condescendencia de tu amor!	La	m	Sol		La	m
¡Oh incomparable ternura y caridad!,	Do		La	m
por rescatar al esclavo has sacrificado al Hijo.	Sol		La	m
Sin el pecado de Adán,	Fa		Mi	7	
Cristo no nos habría rescatado.	Fa		Mi	7
¡OH FELIZ CULPA QUE MERECIÓ	La	m
TAN GRANDE REDENTOR!	Sol	
¡OH FELIZ CULPA!	La	m
¡Oh noche maravillosa	La	m	Sol	
en que despojaste al Faraón	
y enriqueciste a Israel!	La	m
¡Oh noche maravillosa,	La	m	Sol	
tú sola conociste la hora	
en que Cristo resucitó!	La	m
¡Oh noche que destruyes el pecado	La	m	Sol	
y lavas todas nuestras culpas!	La	m
¡Oh noche realmente gloriosa	La	m	Sol	
que reconcilias	Fa	
al hombre con su Dios!	Mi	7
ESTA ES LA NOCHE	La	m
EN QUE CRISTO HA VENCIDO LA MUERTE BIS	Sol	
Y DEL INFIERNO RETORNA VICTORIOSO.	Fa		Mi	
En esta noche acepta, Padre Santo,	La	m	Sol	
este sacrificio de alabanza que la Iglesia	La	m	Do	
te ofrece por medio de sus ministros	La	m
en la liturgia solemne de este cirio,	Sol	
que es el signo de la nueva luz.	Lam	
Te rogamos, Señor, que este cirio	Fa		Mi	7	La	m
ofrecido en el honor de tu nombre	Sol	
brille radiante;	La	m
llegue hasta ti, como perfume suave,	Sol	
se confunda con las estrellas del cielo.	La	m
Lo encuentre encendido el lucero de la mañana,	Sol	
esa estrella que no conoce el ocaso.	Fa		Mi	7	
QUE ES CRISTO TU HIJO,	La	m
RESUCITADO, RESUCITADO	Sol		Fa	
DE LA MUERTE.	Mi	
AMÉN, AMÉN, AMÉN.	La	m	Sol		La	m