Santo, Santo, Santo.	La	m	Sol		La	m
SANTO,SANTO,SANTO.	Sol		La	m
Los cielos y la tierra	La	m	Sol	
están llenos de tu Gloria.	La	m
LOS CIELOS Y LA TIERRA	Sol	
ESTÁN LLENOS DE TU GLORIA.	La	m
Hosanna en lo alto del Cielo.	Fa		Mi	
HOSANNA EN LO ALTO DEL CIELO.	Fa		Mi	
A SANTO,SANTO,SANTO.	La	m	Sol		La	m
SANTO,SANTO,SANTO.	Sol		La	m
Bendito es el que viene	La	m	Sol	
en el nombre del Señor.	La	m
BENDITO ES EL QUE VIENE	Sol	
EN EL NOMBRE DEL SEÑOR.	La	m
Hosanna en lo alto del Cielo.	Fa		Mi	
HOSANNA EN LO ALTO DEL CIELO.	Fa		Mi	
SANTO,SANTO,SANTO.	La	m	Sol		La	m
SANTO,SANTO,SANTO.	Sol		La	m
Santo, Santo, Santo.	Fa		Mi	
SANTO,SANTO,SANTO.	Fa		Mi	