Habéis oído que se dijo:	Re	
«Ojo por ojo, y diente por diente».	Si	m
Mas yo os digo, mas yo os digo:	La		Si	m
NO RESISTÁIS AL MAL,	Re	
NO RESISTÁIS AL MAL,	Si	m
NO RESISTÁIS AL MAL,	La	
NO RESISTÁIS AL MAL.	Si	m
Y si alguno te golpea en la mejilla derecha	Si	m	Re	
preséntale también la otra.	La		Si	m
Y si alguno	Si	m
te lleva a juicio para quitarte la túnica	Re	
déjale también el manto.	La		Si	m
Al que te obligue a andar una milla,	La	
vete con él dos.	Si	m
Y al que te robe lo que es tuyo,	La	
no se lo reclames.	Si	m
NO RESISTÁIS AL MAL. ..	Re	
Habéis oído que se dijo:	Re	
«Amarás a tu prójimo y odiarás a tu enemigo».	Si	m
Mas yo os digo, mas yo os digo:	La		Si	m
Amad a vuestros enemigos,	Re	
haced el bien a los que os odian,	Si	m
rezad por los que os persiguen,	La	
bendecid a los que os calumnian.	Si	m
Y seréis hijos de vuestro Padre celeste,	Re	
que hace salir su sol sobre buenos y malos	La	 	Si	m
y manda la lluvia también	La	
sobre los pecadores.	Si	m
A NO RESISTÁIS AL MAL. ..	Re	
Sed perfectos	Sol	
como vuestro Padre celestial es perfecto,	Si	m
porque Él es bueno con los malvados,	Sol		La	
porque Él es bueno con los pecadores.	Sol		La	
NO RESISTÁIS AL MAL. ..	Re