Señor, tú me escrutas y conoces,	Re	m	Sol	m
tú sabes cuando me acuesto y me levanto.	Re	m	
Sondeas mis pensamientos desde lejos,	Sol	m	
te son familiares todas mis sendas.	Sol	m6	Re	m
Que no está aún en mi lengua la palabra,	Do		Do	7	Fa	
y ya tú, Señor, te la sabes toda.	La		Re	m	
Me acosas por detrás,	Do	
me atacas por delante,	Fa	
y al mismo tiempo	La	
tienes puesta sobre mí tu mano.	Re	m	
Y esto es ciencia misteriosa para mí,	Sol	m	La	
ciencia que no llego a comprender,	Sol	m	La	
ciencia tan alta, que yo no la entiendo.	Sol	m	La	
¿A DÓNDE IRÉ YO LEJOS DE TU ESPÍRITU?	Fa		La	m	
¿A DÓNDE DE TU ROSTRO ESCAPARÉ?	Si♭	
SI SUBO HASTA EL CIELO, ALLÍ ESTÁS TÚ,	La	
SI DESCIENDO HASTA LA MUERTE,	Si♭	
ALLÍ TE ENCUENTRO.	La	
ME ACOSAS POR DETRÁS,	Fa	
ME ATACAS POR DELANTE,	La	m
Y AL MISMO TIEMPO	
TIENES PUESTA SOBRE MÍ TU MANO.	Si♭	
Y ESTO ES CIENCIA MISTERIOSA PARA MÍ,	La	
CIENCIA QUE NO LLEGO A COMPRENDER,	Si♭		La	
CIENCIA TAN ALTA,	Si♭	
QUE YO NO LA ENTIENDO.	La	
Señor, tú me escrutas y conoces,	Re	m	Sol	m
sondeas y pruebas mi corazón,	Re	m	
para que no siga un camino de doblez,	Sol	m	
para que no me aparte nunca	
de tu camino.	Re	m	
