Dios mío, Dios mío,	Re		Fa#	m
me has llevado, me has llevado	Si	m	
y me has hecho caminar entre tinieblas.	Re
Has construido para mí un yugo,	Fa#	m
has atado mi cabeza, mi cabeza	Si	m	
y la barbilla.	Re	
Has tensado tu arco,	Fa#	m
y me has fijado, me has fijado	Si	m	
como blanco de tus flechas.	Re
Aun cuando grito y gimo,	Fa#	m
tú sofocas, sofocas	Si	m
mi oración.	Re
Contemplar mi miseria	Mi	m
y mi vida errante	La	
es para mí hiel y amargura.	Re
¿Mas qué puedo hacer	Fa#
si hasta me falta la esperanza,	Si	m
la esperanza que viene del Señor,	La		Sol	
que viene del Señor?	Fa#
SIÉNTATE SOLITARIO Y SILENCIOSO,	Re	 	Fa#	m
PORQUE DIOS TE LO HA IMPUESTO.	Si	m		Re	
HUMILLA TU BOCA EN EL POLVO,	Fa#	m
QUIZÁ HAYA ESPERANZA.		Si	m		Re
PON LA MEJILLA A QUIEN TE HIERE:	Mi	m	La	7
PORQUE NO RECHAZA		Sol	
PARA SIEMPRE EL SEÑOR.	La
AUN CUANDO AFLIGE	sol
USA DE MISERICORDIA,	La
según su gran amor.	La	7	Re